XXXXXXXXXXXXXXXXXXXXXXXXXXXXXXX
X                             X
X             BB              X
X                             X
XXXXXXXXXX               XXXXXX
XXXXXXXXXX               XXXXXX
XXXXXXXXXX     XXXXXXXXXXXXXXXX
X              X              X
X              X              X
X    GG        X              X
X              X              X
X              X              X
X                             X
X                             X
XXXXXXXXXXX         XXXXXXXXXXX
X                             X
X              S              X
X                             X
