XXXXXXXXXXXXXXXXXXXXXXXXXXXXXXXXXXXXXXXX
X C                 B                C X
X    X                           X     X
X    X         C       C         X     X
X    X       XXXXXXXXXXXXXX      X     X
X                                      X
X                                GGG   X
X                                      X
XXXXXXXX                       XXXXXXXXX
XXXXXXXX          G            XXXXXXXXX

